1,10,7
##########
#        #
# ###### #
# #      #
# ########
#        #
##########
1,1,START
3,3,RED KEY
1,3,KEY DOOR, RED
8,5,GOAL

