10,7
##########
#        #
# ###### #
# #      #
# ########
#        #
##########
2,2,START
4,4,RED KEY
2,4,KEY DOOR, RED
9,6,GOAL

